150
23
22 22 22 22 22 22 22 22 22 22 22 22 22 22 22 22 22 22 22 22 22 22 22 22 22 22 22 22 22 22 22 22 22 22 22 22 22 22 22 22 22 22 22 22 22 22 22 22 22 22 22 22 22 22 22 22 22 22 22 22 22 22 22 22 22 22 22 22 22 22 22 22 22 22 22 22 22 22 22 22 22 22 22 22 22 22 22 22 22 22 22 22 22 22 22 22 22 22 22 22 22 22 22 22 22 22 22 22 22 22 22 22 22 22 22 22 22 22 22 22 22 22 22 22 22 22 22 22 22 22 22 22 22 22 22 22 22 22 22 22 22 22 22 22 22 22 22 22 22 22 
22 22 19 17 17 17 17 17 17 17 17 17 17 17 17 17 17 17 17 17 17 17 17 17 17 17 17 17 17 17 17 17 17 17 17 17 17 17 17 17 17 17 17 17 17 17 17 17 17 17 17 17 17 18 22 22 22 22 22 22 22 22 22 22 22 22 22 22 19 17 17 17 17 17 17 17 17 17 17 17 17 17 17 17 17 17 17 17 17 17 17 17 17 17 17 17 17 17 17 17 17 17 18 22 22 22 22 22 22 22 22 22 22 22 22 22 22 22 22 22 22 22 22 19 17 17 17 17 18 22 22 22 22 19 17 17 17 17 17 17 17 17 17 17 17 17 17 17 18 22 
22 22 4 0 0 0 0 0 0 0 0 0 0 0 0 0 0 0 0 0 0 0 0 0 0 0 0 0 0 0 0 0 0 0 0 0 0 0 0 0 0 0 0 0 0 0 0 0 0 0 0 0 0 0 17 18 22 22 22 22 22 22 22 19 17 17 17 17 0 0 0 0 0 0 0 0 0 0 0 0 0 23 24 25 0 0 0 0 0 0 0 0 0 0 0 0 0 0 0 0 0 0 9 17 17 17 17 15 15 15 15 15 22 19 17 17 18 22 17 22 22 22 22 4 0 0 0 0 0 18 22 22 19 0 0 0 0 0 0 0 0 0 1 21 21 21 21 21 2 22 
22 22 4 0 0 0 0 0 0 0 0 0 0 0 0 0 0 0 0 0 0 0 0 0 0 0 0 0 11 0 0 0 0 0 0 0 0 0 0 0 0 0 0 0 1 21 2 0 0 0 0 0 0 0 0 0 17 17 18 22 22 19 17 0 0 0 0 0 0 0 0 0 1 21 2 0 0 0 0 0 0 0 0 0 0 0 0 0 0 0 0 0 0 0 0 0 0 0 0 0 0 0 23 21 21 21 8 21 28 15 15 0 22 1 21 21 2 22 4 17 18 22 19 0 0 0 0 0 0 0 18 22 4 0 0 0 0 0 0 0 0 0 0 18 22 22 22 19 3 22 
22 22 4 0 0 0 11 0 0 9 0 0 0 0 11 0 0 0 0 0 0 0 0 0 0 0 0 23 24 25 0 23 21 2 0 0 0 0 0 0 0 0 0 0 0 22 4 0 0 0 0 0 0 0 0 0 0 0 0 17 17 0 0 0 0 0 0 0 0 0 0 1 21 28 16 16 21 21 21 2 0 0 0 1 21 2 0 23 24 25 0 0 0 0 0 11 0 10 0 0 0 0 3 22 19 17 0 22 22 27 21 28 19 0 22 19 3 22 4 9 0 17 0 0 0 0 0 0 0 0 0 17 0 0 0 0 0 0 0 0 0 0 0 0 18 22 22 1 21 28 
22 22 4 0 0 23 24 24 24 21 2 0 0 0 23 24 25 0 0 0 0 0 23 25 0 0 0 0 0 0 0 3 22 0 0 0 0 0 0 0 0 0 0 1 21 28 4 0 0 0 0 0 0 0 0 0 0 0 0 0 0 0 0 0 0 0 0 0 1 21 21 21 28 22 15 22 22 22 27 21 21 2 0 0 22 0 0 0 0 0 0 0 0 0 23 24 24 24 25 0 0 0 3 22 1 21 21 22 19 17 17 17 1 21 2 1 21 2 1 21 2 0 0 0 0 0 0 0 0 0 1 21 2 0 0 0 0 0 0 23 25 0 0 0 0 18 22 14 22 22 
22 15 11 0 0 0 0 0 0 27 21 2 0 0 0 10 1 21 2 0 11 0 0 0 0 0 0 0 0 0 0 3 22 20 0 11 11 0 0 0 0 10 1 21 28 15 16 0 0 0 0 0 0 0 1 21 2 0 0 0 1 21 21 2 0 0 1 21 21 28 22 22 22 22 15 22 22 22 22 22 27 21 21 21 29 21 2 0 0 0 0 0 0 0 0 0 0 0 0 0 0 0 3 22 4 17 17 17 1 21 21 21 21 29 21 2 0 1 21 28 0 0 0 0 0 9 0 0 10 1 21 28 0 0 11 16 16 16 16 16 0 0 0 0 0 3 22 4 18 22 
21 21 21 26 26 26 26 26 26 22 27 21 21 21 21 21 21 29 21 21 21 21 2 0 0 0 0 0 0 0 0 3 27 21 21 21 21 21 21 21 21 21 21 28 22 15 15 21 21 21 21 21 21 21 21 29 21 21 21 21 21 21 29 21 21 21 21 22 22 22 22 22 22 22 15 15 22 22 22 22 22 22 22 22 22 22 0 0 0 0 0 0 0 0 0 0 0 0 0 0 0 0 3 27 21 21 21 21 21 28 22 22 27 21 21 21 21 21 28 27 21 21 21 21 21 21 21 21 21 21 28 27 21 21 21 21 21 21 21 21 21 21 21 21 21 21 29 21 2 22 
22 22 22 22 22 22 22 22 22 22 22 22 22 22 22 22 22 22 22 22 22 22 16 16 16 16 16 16 16 16 16 16 22 22 22 22 22 22 22 22 22 22 22 22 15 15 15 22 22 22 22 22 22 22 22 22 22 22 22 22 22 22 22 22 22 22 22 22 22 22 22 22 22 22 15 15 15 22 22 22 22 22 22 22 22 27 21 2 0 0 0 20 0 0 0 0 0 0 0 0 0 0 3 22 22 22 22 22 22 22 22 22 22 22 22 22 22 22 22 22 22 22 22 22 22 22 22 22 22 22 22 22 22 22 22 22 22 22 22 22 22 22 22 22 22 22 22 22 14 22 
22 22 22 22 22 22 22 22 22 22 22 22 22 22 22 22 22 22 22 22 22 22 22 22 22 22 22 22 22 22 22 22 22 22 22 22 22 22 22 22 22 22 22 15 15 15 22 22 22 22 22 22 22 22 22 22 22 22 22 22 22 22 22 22 22 22 22 22 22 22 22 22 15 15 15 15 15 15 15 15 15 15 15 15 15 15 15 4 0 0 23 24 25 0 0 0 0 0 0 0 11 9 0 18 22 22 22 22 22 22 22 22 22 22 22 22 22 22 22 22 22 22 22 22 22 22 22 22 22 22 22 22 22 22 22 22 22 22 22 22 22 22 22 22 22 22 22 19 0 22 
22 22 22 22 22 22 22 22 22 22 22 22 22 22 22 22 22 22 22 22 22 22 22 22 22 22 22 22 22 22 22 22 22 22 22 22 22 22 22 22 22 22 22 15 15 15 15 15 15 15 15 22 22 22 22 22 22 22 22 22 22 22 22 22 22 22 22 22 22 22 22 22 22 15 15 15 15 27 21 28 22 22 22 15 22 22 27 21 2 0 0 0 0 0 0 0 0 0 0 0 23 25 0 0 18 22 22 22 22 22 22 22 22 22 22 22 22 22 22 22 22 22 22 22 22 22 22 22 22 22 22 22 22 22 22 22 22 22 22 22 22 22 22 22 22 22 22 1 21 28 
22 22 22 22 22 22 22 22 22 22 22 22 22 22 22 22 22 22 22 22 22 22 22 22 22 22 22 22 22 22 22 22 22 22 22 22 22 22 22 22 22 22 27 21 21 2 0 0 15 15 15 15 22 22 22 22 22 22 22 22 22 22 22 22 22 22 22 22 22 22 22 22 27 21 21 21 21 28 22 22 22 22 22 22 22 22 22 22 4 0 0 0 0 0 0 11 0 0 0 0 0 0 0 0 3 22 22 22 22 22 22 22 22 22 22 22 22 22 22 22 22 22 22 22 22 22 22 22 22 22 22 22 22 22 22 22 22 22 22 22 22 22 22 22 22 22 22 14 22 22 
0 0 0 0 0 0 0 0 0 0 0 0 0 0 0 0 22 22 22 22 22 22 22 22 22 22 22 22 22 22 22 22 22 22 22 22 22 22 22 22 22 22 22 22 27 21 21 2 0 0 15 15 15 22 22 22 22 22 22 22 22 22 22 22 22 22 22 22 22 19 18 22 22 22 22 22 22 22 22 22 22 22 22 22 22 22 22 22 4 0 0 0 0 0 0 23 25 0 0 0 0 0 0 0 0 18 22 22 22 22 22 22 22 22 0 0 0 0 0 0 0 0 0 0 0 0 0 0 0 0 0 0 0 22 22 22 22 22 22 22 22 22 22 22 22 22 22 4 18 22 
0 0 0 0 0 0 0 0 0 0 0 0 0 0 0 0 0 0 0 0 0 0 0 22 0 0 22 22 22 22 22 22 22 22 22 22 22 22 22 22 22 22 22 22 22 22 27 21 2 0 0 0 0 0 22 22 22 22 22 22 22 22 22 22 22 22 22 22 22 4 0 18 22 22 22 22 22 19 18 22 22 22 22 22 22 22 22 22 4 0 0 0 0 0 0 0 0 0 0 0 0 0 0 0 0 3 22 22 22 22 22 22 22 22 22 0 0 0 0 0 0 0 0 0 0 0 0 0 0 0 0 0 0 0 22 22 22 22 22 22 22 22 22 22 22 22 22 4 3 22 
0 0 0 0 0 0 0 0 0 0 0 0 0 0 0 0 0 0 0 0 0 0 0 0 0 0 0 0 0 0 0 0 0 22 22 22 0 22 22 22 22 22 22 22 22 22 22 27 21 2 0 0 0 0 22 22 22 22 22 22 22 22 22 22 22 0 22 22 19 0 0 0 18 22 22 22 22 4 3 22 22 19 22 22 22 22 22 22 4 0 0 0 0 0 0 0 0 0 0 0 0 0 0 0 0 3 22 22 22 22 22 22 22 22 0 0 0 0 0 0 0 0 0 0 0 0 0 0 0 0 0 0 0 0 0 0 22 22 22 22 22 22 22 22 22 22 22 4 3 22 
0 0 0 0 0 0 0 0 0 0 0 0 0 0 0 0 0 0 0 0 0 0 0 0 0 0 0 0 0 0 0 0 0 22 0 0 0 22 22 22 22 22 22 22 22 22 22 22 19 23 24 24 24 25 18 22 22 22 22 22 22 22 0 0 22 0 0 22 4 0 0 0 0 18 22 22 19 0 3 22 19 3 22 22 22 22 22 22 4 0 0 0 0 0 0 0 0 0 0 0 0 0 0 0 0 3 22 22 22 22 22 22 22 0 0 0 0 0 0 0 0 0 0 0 0 0 0 0 0 0 0 0 0 0 0 0 0 22 22 22 22 22 22 22 22 22 22 4 3 22 
0 0 0 0 0 0 0 0 0 0 0 0 0 0 0 0 0 0 0 0 0 0 0 0 0 0 0 0 0 0 0 0 0 22 0 0 0 0 0 0 0 22 22 22 22 22 22 22 4 0 0 0 0 0 3 22 22 22 22 22 22 22 0 0 22 0 0 22 0 0 0 0 0 3 22 22 4 0 0 17 0 0 18 22 22 22 22 22 4 0 0 0 0 0 0 0 0 0 0 0 0 0 0 0 0 3 22 22 22 22 22 22 22 0 0 0 0 0 0 0 0 0 0 0 0 0 0 0 0 0 0 0 0 0 0 0 0 0 0 22 22 22 22 22 22 22 22 4 3 22 
0 0 0 0 0 0 0 0 0 0 0 0 0 0 0 0 0 0 0 0 0 0 0 0 0 0 0 0 0 0 0 0 0 22 22 0 0 0 0 0 0 22 22 22 22 19 18 22 4 0 0 0 0 0 0 17 17 18 22 22 22 0 0 0 22 0 0 0 0 0 0 0 0 0 18 22 4 0 0 0 0 0 3 22 22 22 22 27 21 2 0 0 0 0 0 0 0 0 0 0 0 0 0 0 0 16 22 22 22 22 22 22 0 0 0 0 0 0 0 0 0 0 0 0 0 0 0 0 0 0 0 0 0 0 0 0 0 0 0 0 22 22 22 22 22 22 22 4 3 22 
0 0 0 0 0 0 0 0 0 0 0 0 0 0 0 0 0 0 0 0 0 0 0 0 0 0 0 0 0 0 0 0 0 0 22 0 0 0 0 0 0 22 22 22 22 4 3 22 4 0 0 0 0 0 0 0 0 0 18 22 22 0 0 0 0 0 0 0 0 0 0 0 0 0 0 17 0 0 0 0 0 0 0 18 22 22 22 22 27 21 2 0 0 0 0 0 0 0 0 0 0 0 0 0 16 21 28 22 22 22 22 22 0 0 0 0 0 0 0 0 0 0 0 0 0 0 0 0 0 0 0 0 0 0 0 0 0 0 0 0 22 22 22 22 22 22 22 4 3 22 
0 0 0 0 0 0 0 0 0 0 0 0 0 0 0 0 0 0 0 0 0 0 0 0 0 0 0 0 0 0 0 0 0 0 0 0 0 0 0 0 0 22 22 22 22 4 0 17 0 0 0 0 0 0 0 23 25 0 3 22 22 0 0 0 0 0 0 0 0 0 0 0 0 0 0 0 0 0 0 0 0 0 0 0 22 22 22 22 22 27 21 21 16 0 0 0 0 0 0 0 0 0 0 16 21 28 22 22 22 22 22 0 0 0 0 0 0 0 0 0 0 0 0 0 0 0 0 0 0 0 0 0 0 0 0 0 0 0 0 0 22 22 22 22 22 22 22 4 3 22 
0 0 0 0 0 0 0 0 0 0 0 0 0 0 0 0 0 0 0 0 0 0 0 0 0 0 0 0 0 0 0 0 0 0 0 0 0 0 0 0 0 0 22 22 22 4 0 0 23 24 25 0 0 0 0 0 0 0 0 0 22 0 0 0 0 0 0 0 0 0 0 0 0 0 0 0 0 0 0 0 0 0 0 0 0 22 22 22 22 22 22 27 21 0 0 0 0 0 0 0 0 0 16 21 28 22 22 22 22 22 22 0 0 0 0 0 0 0 0 0 0 0 0 0 0 0 0 0 0 0 0 0 0 0 0 0 0 0 0 0 22 22 22 22 22 22 22 4 3 22 
0 0 0 0 0 0 0 0 0 0 0 0 0 0 0 0 0 0 0 0 0 0 0 0 0 0 0 0 0 0 0 0 0 0 0 0 0 0 0 0 0 0 22 22 22 4 0 0 0 0 0 0 0 0 0 0 0 0 0 0 0 22 0 0 0 0 0 0 0 0 0 0 0 0 0 0 0 0 0 0 0 0 0 0 22 22 22 22 22 22 22 22 22 26 26 26 26 26 26 26 26 26 21 28 22 22 22 22 22 22 22 0 0 0 0 0 0 0 0 0 0 0 0 0 0 0 0 0 0 0 0 0 0 0 0 0 0 0 0 0 22 22 22 22 22 22 22 4 3 22 
0 0 0 0 0 0 0 0 0 0 0 0 0 0 0 0 0 0 0 0 0 0 0 0 0 0 0 0 0 0 0 0 0 0 0 0 0 0 0 0 0 0 22 22 22 4 0 0 0 0 0 0 0 0 0 0 0 0 0 0 0 22 0 0 0 0 0 0 0 0 0 0 0 0 0 0 0 0 0 0 0 0 0 0 22 22 22 22 22 22 22 22 22 22 22 22 22 22 22 22 22 22 22 22 22 22 22 22 22 0 0 0 0 0 0 0 0 0 0 0 0 0 0 0 0 0 0 0 0 0 0 0 0 0 0 0 0 0 0 0 22 22 22 22 22 22 22 4 3 22 
