58
53
22 22 22 22 22 22 22 22 22 22 22 22 22 22 22 22 22 22 22 22 22 22 22 22 22 22 22 22 22 22 22 22 22 22 22 22 22 22 22 22 22 22 22 22 22 22 22 22 22 22 22 22 22 22 22 22 22 22 
22 22 22 22 22 22 22 22 22 22 22 22 22 22 22 22 22 22 22 22 22 22 22 22 22 22 22 22 22 22 22 22 22 22 22 22 22 22 22 22 22 22 22 22 22 22 22 22 22 22 22 0 0 22 22 22 22 22 
22 22 22 22 22 22 22 22 22 22 22 22 22 22 22 22 22 22 22 22 22 22 22 22 22 22 22 0 0 0 0 0 0 0 22 22 22 22 22 22 22 22 22 22 22 22 22 22 22 22 0 0 0 22 22 22 22 22 
22 22 22 22 22 22 22 22 22 22 22 22 22 22 22 22 22 22 22 22 22 22 22 22 22 22 22 0 0 22 22 22 22 22 22 22 22 0 0 0 0 0 0 0 0 0 0 0 0 0 0 23 21 28 22 22 22 22 
22 22 22 22 22 22 22 22 22 22 22 22 22 22 22 22 22 22 22 22 0 0 0 22 22 22 0 0 0 0 22 22 22 22 22 0 0 22 0 0 22 22 22 22 22 22 22 0 22 22 22 22 22 22 22 22 22 22 
22 22 22 22 22 22 22 22 0 0 0 0 0 0 22 22 22 22 22 0 0 22 22 22 22 22 0 0 22 0 22 22 22 22 22 22 22 22 22 0 0 22 22 22 22 22 22 0 22 22 22 22 22 22 22 22 22 22 
22 22 22 22 22 22 22 0 0 22 22 22 22 0 0 22 22 22 22 0 0 22 22 22 22 22 22 22 22 22 22 22 22 22 22 22 22 22 22 22 0 0 22 22 22 22 0 0 22 22 22 22 22 22 22 22 22 22 
22 22 22 22 22 22 22 0 0 22 22 22 22 22 0 22 22 22 22 22 0 0 22 22 22 22 22 22 22 22 22 22 22 22 22 22 22 22 22 22 22 0 0 22 22 22 0 22 22 22 22 22 22 22 22 22 22 22 
22 22 22 22 22 22 22 22 0 22 22 22 22 22 0 22 22 22 22 22 22 0 22 22 0 22 22 22 22 22 22 22 22 22 22 22 0 0 0 22 22 22 22 22 22 0 0 22 22 22 22 22 22 22 22 22 22 22 
22 22 22 22 22 22 22 22 0 0 22 22 22 22 0 0 0 0 0 22 22 22 0 22 0 22 22 22 22 22 22 22 22 22 22 22 22 22 0 0 22 22 0 0 0 0 0 0 0 22 22 22 22 22 22 22 22 22 
22 22 22 22 22 22 22 22 22 0 22 0 0 22 22 22 22 0 0 0 22 22 0 0 0 22 22 0 0 0 0 0 0 0 0 0 22 22 22 0 0 0 0 22 0 22 22 22 0 0 0 22 22 22 22 22 22 22 
22 22 22 22 22 22 22 22 0 0 22 0 0 22 22 22 0 0 0 0 22 22 0 0 22 22 22 22 22 22 22 22 22 22 22 0 22 22 22 22 22 22 22 22 0 0 22 22 22 22 0 22 22 22 22 22 22 22 
22 22 22 22 22 22 0 0 0 22 22 22 0 22 22 22 0 22 22 22 22 22 22 22 22 22 0 0 0 22 22 22 22 22 0 0 22 22 22 22 22 22 22 22 22 0 0 22 22 22 0 0 22 22 22 22 22 22 
22 22 22 22 22 22 0 22 22 22 0 0 0 22 0 22 0 22 22 22 22 22 22 22 22 0 0 22 22 22 22 22 22 22 0 22 22 0 0 0 0 0 22 22 22 22 0 0 22 22 22 0 22 22 22 22 22 22 
22 22 22 22 22 22 22 22 22 0 0 22 0 0 0 0 0 22 22 22 22 22 22 22 22 0 22 22 22 22 22 22 22 22 0 0 0 0 22 22 22 0 0 0 22 22 22 0 0 22 22 22 22 22 22 22 22 22 
22 22 22 22 22 22 22 0 0 0 22 22 0 22 22 22 22 22 22 22 22 22 22 22 22 22 22 0 0 0 0 22 22 22 22 0 0 22 22 22 22 22 22 0 22 0 22 22 0 22 22 0 22 22 22 22 22 22 
22 22 22 22 22 22 0 0 22 22 0 0 0 0 22 22 22 22 22 22 22 22 22 22 22 22 22 0 0 0 0 22 22 22 22 22 0 0 0 0 0 22 22 0 0 0 0 0 0 22 22 0 22 22 22 22 22 22 
22 22 22 22 22 0 0 22 22 22 22 22 22 0 22 22 22 22 22 22 22 22 22 22 22 22 22 22 22 22 22 22 22 22 22 22 22 22 22 22 0 0 22 22 22 22 0 22 22 22 0 0 22 22 22 22 22 22 
22 22 22 22 22 0 0 0 0 22 22 22 22 0 0 22 22 22 22 22 0 0 0 22 22 22 22 22 22 22 22 22 22 22 22 22 22 22 22 22 22 22 0 0 0 0 0 0 0 0 0 0 22 22 22 22 22 22 
22 22 22 22 22 0 22 22 0 22 22 22 22 22 0 0 0 0 22 22 0 22 0 22 22 22 22 22 22 22 0 0 22 0 0 0 22 22 22 22 22 0 22 22 22 22 22 22 22 0 22 22 22 22 22 22 22 22 
22 22 22 22 22 0 0 22 0 0 0 22 22 22 22 22 22 0 0 22 0 22 0 0 22 22 22 0 0 0 0 22 22 22 22 22 22 22 22 22 22 0 22 22 22 22 0 0 0 0 22 22 22 22 22 22 22 22 
22 22 22 22 22 22 0 22 22 22 0 0 22 22 22 22 22 22 0 0 0 22 22 0 0 22 0 0 0 0 22 0 0 0 0 0 0 0 22 22 22 0 0 22 22 22 0 22 22 22 22 22 22 22 22 22 22 22 
22 22 22 22 22 0 0 0 0 0 22 22 22 22 22 22 22 0 0 22 22 22 22 22 0 0 22 22 22 22 22 0 0 22 22 22 22 0 0 22 22 22 0 0 0 0 0 22 22 22 22 22 22 22 22 22 22 22 
22 22 22 22 22 0 22 22 22 0 0 0 22 22 22 22 0 0 22 22 22 22 0 0 0 0 22 22 22 22 0 0 22 22 0 22 22 22 0 0 22 0 0 22 22 22 0 22 22 22 22 22 22 22 22 22 22 22 
22 22 22 22 22 0 0 22 22 0 22 0 0 0 0 22 0 22 22 22 22 22 0 22 0 0 22 0 0 0 0 22 22 0 22 22 22 22 22 22 0 0 22 22 22 22 0 0 22 22 22 22 22 22 22 22 22 22 
22 22 22 22 22 0 22 22 0 0 22 22 22 22 0 0 0 22 22 22 22 22 0 0 22 22 22 22 0 22 22 22 22 0 22 22 22 22 22 22 0 22 22 22 22 22 0 22 22 22 22 22 22 22 22 22 22 22 
22 22 22 22 22 0 22 0 0 22 22 22 22 22 22 22 0 0 22 0 0 0 22 0 22 22 22 22 0 0 22 22 22 0 0 0 22 22 22 22 0 22 22 22 22 22 22 0 22 22 22 22 22 22 22 22 22 22 
22 22 22 22 22 0 22 0 22 22 22 22 22 22 22 22 22 0 0 0 22 0 0 0 0 22 22 22 22 0 0 22 22 0 22 0 22 22 22 22 0 0 0 0 0 22 22 0 22 22 22 22 22 22 22 22 22 22 
22 22 22 22 22 0 22 0 22 22 22 22 22 22 22 22 22 0 0 22 22 22 22 22 0 0 22 22 22 22 0 0 0 0 22 0 0 22 22 22 22 22 22 22 0 0 0 0 22 22 22 22 22 22 22 22 22 22 
22 22 22 22 22 0 22 0 22 22 22 22 0 0 0 22 22 22 22 22 22 22 22 22 22 0 0 22 22 22 22 22 22 22 22 22 0 0 0 0 22 0 0 0 0 0 0 22 22 22 22 22 22 22 22 22 22 22 
22 22 22 22 22 0 22 0 0 0 0 0 0 22 0 22 22 22 22 22 22 22 22 22 22 0 0 0 22 22 22 22 22 22 22 22 22 22 22 0 0 0 0 0 22 22 22 22 22 22 22 22 22 22 22 22 22 22 
22 22 22 22 22 0 22 22 22 22 22 22 22 22 0 22 22 22 22 22 0 0 0 22 0 0 22 0 0 22 22 22 22 22 22 22 22 22 22 22 22 22 0 22 22 22 22 22 22 22 22 0 22 22 22 22 22 22 
22 22 22 22 22 0 22 22 22 22 22 22 22 0 0 22 22 22 0 0 0 22 0 0 0 22 22 22 0 0 22 22 22 22 22 22 22 22 22 22 22 22 0 0 22 22 22 22 22 22 22 0 22 22 22 22 22 22 
22 22 22 22 22 0 22 0 0 22 22 22 22 0 0 22 22 0 0 22 22 22 22 22 22 22 22 22 22 0 0 0 0 0 0 0 22 22 22 22 22 22 22 0 0 22 22 22 22 22 0 0 22 22 22 22 22 22 
22 22 22 22 22 0 22 22 0 0 0 0 0 22 0 22 22 0 22 22 22 0 0 0 0 0 0 0 22 22 22 22 22 22 22 0 22 22 22 22 22 22 22 22 0 0 22 22 22 22 0 0 22 22 22 22 22 22 
22 22 22 22 22 0 22 22 22 22 22 22 0 0 0 0 22 22 22 22 22 0 22 22 22 22 22 0 0 0 0 0 22 22 22 0 0 0 0 0 22 22 22 22 22 0 0 0 22 0 22 0 0 22 22 22 22 22 
22 22 22 22 22 0 0 0 0 0 0 22 22 0 0 0 22 22 22 22 0 22 22 0 0 0 22 22 22 22 22 0 0 0 0 22 22 22 22 0 0 22 22 22 22 22 0 22 22 22 22 22 0 22 22 22 22 22 
22 22 22 22 22 0 0 0 0 22 0 0 22 22 22 22 22 22 22 22 0 22 22 22 0 0 0 22 22 0 0 0 22 22 0 0 22 22 22 22 0 0 22 22 22 22 0 22 22 22 22 0 0 22 22 22 22 22 
22 22 22 22 22 22 22 22 22 22 22 0 22 22 22 22 22 22 22 22 0 22 22 22 22 0 0 22 0 0 22 22 22 22 22 0 0 0 22 22 22 0 22 22 22 0 0 22 22 22 22 0 22 22 22 22 22 22 
22 22 22 22 22 22 22 22 22 22 22 0 0 0 0 22 22 22 22 22 0 0 22 22 22 0 22 0 0 0 22 22 22 22 22 22 22 0 22 22 22 0 0 0 0 0 22 22 22 22 0 0 22 22 22 22 22 22 
22 22 22 22 22 22 22 0 0 0 0 0 0 22 0 0 0 22 22 22 22 0 0 0 22 0 22 0 22 22 22 22 22 22 22 22 22 0 0 22 22 22 22 22 22 22 0 0 0 0 0 22 22 22 22 22 22 22 
22 22 22 22 22 22 0 0 22 22 0 0 0 22 22 22 22 0 0 22 22 22 22 0 22 0 0 0 0 0 22 22 22 22 22 22 22 22 0 0 22 22 22 22 22 22 22 0 0 22 22 22 22 22 22 22 22 22 
22 22 22 22 22 22 0 22 22 22 22 0 0 22 22 22 22 22 0 0 22 22 0 0 22 22 22 22 22 0 22 22 22 22 22 22 22 22 22 22 0 22 22 22 22 22 22 0 22 22 22 22 22 22 22 22 22 22 
22 22 22 22 22 22 0 0 22 22 22 22 0 0 22 22 22 22 22 0 22 22 0 22 22 22 22 22 22 0 0 22 22 22 0 0 22 22 22 22 22 0 0 22 0 0 0 0 22 22 22 22 22 22 22 22 22 22 
22 22 22 22 22 22 22 0 0 22 22 22 22 0 22 22 22 22 22 22 22 22 0 0 22 22 22 22 22 22 22 0 0 22 0 0 22 22 0 22 0 0 0 0 0 0 22 22 22 22 22 22 22 22 22 22 22 22 
22 22 22 22 22 22 22 22 0 22 22 22 22 0 0 22 22 22 22 22 0 22 22 0 0 0 22 22 22 22 22 22 0 0 0 0 22 22 0 22 22 22 22 22 22 0 0 22 22 22 0 0 22 22 22 22 22 22 
22 22 22 22 22 0 22 22 0 22 22 22 22 22 0 0 0 22 22 22 22 0 22 22 22 22 0 22 22 22 22 22 22 22 0 22 22 22 0 22 22 22 22 22 22 22 0 0 0 0 0 22 22 22 22 22 22 22 
22 22 15 15 0 0 0 0 0 22 22 22 22 22 22 0 0 0 0 0 0 0 0 0 0 22 22 0 0 0 0 0 22 22 22 22 22 0 0 22 22 22 22 22 22 22 22 22 0 0 0 0 22 22 22 22 22 22 
22 22 15 15 0 0 0 0 22 22 22 22 22 22 22 22 22 22 22 22 22 22 22 0 22 22 22 22 22 22 0 22 0 0 0 0 0 0 22 22 22 0 0 0 22 22 22 22 22 22 0 22 22 22 22 22 22 22 
21 21 21 21 21 21 21 21 28 22 22 22 22 22 22 22 22 22 22 22 22 22 22 22 22 22 22 22 22 22 22 22 22 22 22 22 22 22 22 22 22 22 22 22 22 22 22 22 22 22 22 22 22 22 22 22 22 22 
22 22 22 22 22 22 22 22 22 22 22 22 22 22 22 22 22 22 22 22 22 22 22 22 22 22 22 22 22 22 22 22 22 22 22 22 22 22 22 22 22 22 22 22 22 22 22 22 22 22 22 22 22 22 22 22 22 22 
22 22 22 22 22 22 22 22 22 22 22 22 22 22 22 22 22 22 22 22 22 22 22 22 22 22 22 22 22 22 22 22 22 22 22 22 22 22 22 22 22 22 22 22 22 22 22 22 22 22 22 22 22 22 22 22 22 22 
22 22 22 22 22 22 22 22 22 22 22 22 22 22 22 22 22 22 22 22 22 22 22 22 22 22 22 22 22 22 22 22 22 22 22 22 22 22 22 22 22 22 22 22 22 22 22 22 22 22 22 22 22 22 22 22 22 22 
