13
8
0 0 0 0 0 0 0 0 0 0 0 0 0 
0 0 0 0 0 0 0 0 0 0 0 0 0 
0 0 0 0 0 0 0 0 0 30 30 30 0 
0 0 0 0 0 0 0 0 30 0 0 0 30 
0 0 0 0 0 0 0 0 30 0 0 0 30 
0 0 0 0 0 0 0 0 30 0 0 0 30 
0 0 0 0 0 0 0 0 30 0 0 0 30 
0 0 0 0 0 0 0 0 30 23 24 24 24 
