70
8
22 22 22 22 22 22 22 22 22 22 22 22 22 22 22 22 22 22 22 22 22 22 22 22 22 22 22 22 22 22 22 22 22 22 22 22 22 22 22 22 22 22 22 22 22 22 22 22 22 22 22 22 22 22 22 22 22 22 22 22 22 22 22 22 22 22 22 22 22 22 
22 17 17 17 17 17 17 17 17 17 17 17 17 17 17 17 17 17 17 17 17 17 17 17 17 17 17 17 17 17 17 17 17 17 17 17 17 17 17 17 17 17 17 17 17 17 17 17 17 17 18 22 22 22 22 22 19 17 17 17 17 17 17 17 17 17 17 18 22 22 
22 0 0 0 0 0 0 0 0 0 0 0 0 0 0 0 0 0 0 0 0 0 0 0 0 0 0 0 0 0 0 0 0 0 0 0 0 0 0 0 0 0 0 0 0 0 0 0 0 0 0 18 22 19 17 17 0 0 0 0 10 0 0 0 0 0 0 3 22 22 
22 0 0 0 0 0 0 0 0 0 0 0 0 0 0 0 0 0 0 0 0 0 0 0 0 0 0 0 0 0 0 0 0 0 0 0 0 0 9 0 0 0 0 0 0 0 0 0 11 0 0 0 17 0 9 0 0 0 0 23 24 25 0 0 0 0 0 3 22 22 
27 21 2 0 0 0 0 0 0 0 0 0 0 0 0 0 0 0 0 0 0 0 0 0 0 0 13 0 0 0 0 0 0 0 1 21 2 0 23 25 0 0 0 0 0 0 0 1 21 21 21 21 21 21 21 21 2 0 0 0 0 0 0 0 0 0 9 0 15 22 
22 22 4 0 0 12 0 0 0 0 0 0 0 0 0 0 0 0 0 0 0 0 0 0 11 0 0 0 0 0 0 0 0 1 21 28 4 0 0 0 0 0 0 10 9 0 0 23 28 15 15 15 15 15 15 15 4 0 0 0 0 0 0 0 1 21 24 24 24 24 
22 22 4 9 0 0 0 0 9 0 0 11 0 10 0 9 0 11 20 0 0 1 21 21 21 2 0 0 0 11 0 0 1 21 28 22 4 0 0 0 0 0 23 24 25 0 0 3 22 0 15 15 15 15 15 22 4 0 0 20 0 11 0 1 21 28 4 0 0 0 
22 27 21 21 21 21 21 21 21 21 21 21 21 21 21 21 21 21 21 21 21 21 28 22 27 21 21 21 21 21 21 21 21 28 22 22 26 26 26 26 26 26 26 26 26 26 26 26 27 21 21 28 22 22 22 27 21 21 21 21 21 21 21 21 28 22 26 26 26 26 
