101
8
22 22 22 22 22 22 22 22 22 22 22 22 22 22 22 22 22 22 22 22 22 22 22 22 22 22 22 22 22 22 22 22 22 22 22 22 22 22 22 22 22 22 22 22 22 22 22 22 22 22 22 22 22 22 22 22 22 22 22 22 22 22 22 22 22 22 22 22 22 22 22 22 22 22 22 22 22 22 22 22 22 22 22 22 22 22 22 22 22 22 22 22 22 22 22 22 22 22 22 22 22 
22 19 17 17 17 17 17 17 17 17 17 17 17 17 17 17 17 17 17 17 17 17 18 22 22 19 17 17 17 17 17 17 17 18 22 22 19 17 17 17 17 17 17 17 17 17 17 17 17 17 17 17 17 17 17 17 17 17 17 17 17 17 17 17 18 22 19 17 17 17 17 17 17 17 17 17 17 17 17 17 17 17 17 17 18 22 22 20 17 17 17 17 17 17 17 18 22 22 22 22 22 
22 4 0 0 0 0 0 0 0 0 0 0 0 0 0 0 0 0 0 0 0 0 0 18 27 21 21 2 0 11 0 0 1 21 28 19 0 0 0 0 0 0 0 0 0 0 10 9 0 0 0 0 0 0 0 0 0 0 0 0 0 0 0 0 3 22 4 9 0 0 0 0 0 0 0 0 0 0 0 11 0 10 1 21 2 22 27 21 21 2 0 0 0 0 11 3 22 22 22 22 22 
22 0 0 0 0 0 0 0 0 0 0 0 0 0 0 0 0 0 10 0 0 0 0 0 18 22 27 21 21 21 2 0 11 22 19 0 0 0 0 0 0 0 9 0 0 23 24 24 25 0 0 0 0 0 0 23 21 21 2 0 0 0 0 0 3 27 21 21 2 0 0 0 0 0 0 0 0 0 0 23 24 24 24 22 15 22 22 22 19 0 0 0 0 23 24 24 28 22 14 22 22 
24 21 2 0 0 0 0 0 0 0 0 0 0 0 1 21 21 21 21 21 2 0 0 0 0 17 17 17 17 17 20 1 21 28 4 0 0 0 0 0 0 23 25 0 0 0 0 0 0 0 0 11 0 0 0 3 22 22 16 0 0 0 0 0 0 17 18 22 10 0 0 16 1 21 2 0 0 0 0 0 0 0 3 22 15 22 22 19 0 0 0 0 0 0 0 0 17 17 3 22 22 
3 22 4 0 0 0 11 0 0 0 0 0 0 1 21 28 22 22 22 22 4 0 0 0 1 21 21 21 21 21 21 21 28 19 0 20 0 0 0 0 0 0 0 0 11 0 0 0 0 0 0 23 25 0 0 0 18 27 21 2 0 0 0 9 1 21 2 1 21 21 8 21 21 28 4 0 0 9 0 0 0 0 3 22 15 15 19 0 11 0 0 0 0 0 0 0 0 0 3 22 22 
3 22 4 10 0 1 21 21 2 11 0 11 1 21 28 22 22 22 22 22 4 16 16 0 0 17 17 17 17 17 17 17 17 0 1 21 2 0 1 21 2 0 0 0 23 25 0 0 0 0 0 0 0 0 0 0 3 22 27 21 2 11 1 21 21 28 4 9 17 17 11 17 18 22 4 0 23 25 0 0 0 0 3 27 21 21 21 21 21 2 0 16 16 0 0 0 0 0 0 15 22 
26 27 21 21 21 21 28 27 21 21 21 21 21 28 22 22 22 22 22 27 21 21 21 21 21 21 21 21 21 21 21 21 21 21 21 29 21 21 21 29 21 26 26 26 26 26 26 26 26 26 26 26 26 26 26 26 26 26 22 27 21 21 21 28 22 27 21 21 21 21 21 21 21 28 26 26 26 26 26 26 26 26 26 26 26 26 26 22 27 24 24 24 24 21 21 21 21 21 21 21 21 
